/r/Antonym	Antonym
/r/AtLocation	AtLocation
/r/CapableOf	CapableOf
/r/Causes	Causes
/r/CausesDesire	CausesDesire
/r/CreatedBy	CreatedBy
/r/DefinedAs	DefinedAs
/r/DerivedFrom	DerivedFrom
/r/Desires	Desires
/r/DistinctFrom	DistinctFrom
/r/Entails	Entails
/r/EtymologicallyRelatedTo	EtymologicallyRelatedTo
/r/FormOf	FormOf
/r/HasA	HasA
/r/HasContext	HasContext
/r/HasFirstSubevent	HasFirstSubevent
/r/HasLastSubevent	HasLastSubevent
/r/HasPrerequisite	HasPrerequisite
/r/HasProperty	HasProperty
/r/HasSubevent	HasSubevent
/r/IsA	IsA
/r/MadeOf	MadeOf
/r/MannerOf	MannerOf
/r/MotivatedByGoal	MotivatedByGoal
/r/NotCapableOf	NotCapableOf
/r/NotDesires	NotDesires
/r/NotHasProperty	NotHasProperty
/r/PartOf	PartOf
/r/ReceivesAction	ReceivesAction
/r/RelatedTo	RelatedTo
/r/SimilarTo	SimilarTo
/r/Synonym	Synonym
/r/UsedFor	UsedFor
/r/dbpedia/product	product
