/r/Antonym	is the opposite of
/r/AtLocation	is typically found at or in
/r/CapableOf	is capable of doing
/r/Causes	causes the following event or state
/r/CausesDesire	causes the desire to
/r/CreatedBy	is created by
/r/DefinedAs	is defined as
/r/DerivedFrom	is derived from the word or concept
/r/Desires	is something that is desired by
/r/DistinctFrom	DistinctFrom
/r/Entails	Entails
/r/EtymologicallyRelatedTo	EtymologicallyRelatedTo
/r/FormOf	FormOf
/r/HasA	possesses or contains
/r/HasContext	is a word that has a specific context of use
/r/HasFirstSubevent	is an event that begins with the subevent
/r/HasLastSubevent	is an event that ends with the subevent
/r/HasPrerequisite	requires the following as a prerequisite
/r/HasProperty	has the property of being
/r/HasSubevent	is an event that includes the subevent
/r/IsA	is a type of
/r/MadeOf	is made of the substance
/r/MannerOf	is a specific way of doing an action
/r/MotivatedByGoal	MotivatedByGoal
/r/NotCapableOf	NotCapableOf
/r/NotDesires	NotDesires
/r/NotHasProperty	NotHasProperty
/r/PartOf	is a part of
/r/ReceivesAction	is an object that can be acted upon by an action
/r/RelatedTo	is related in some way to
/r/SimilarTo	SimilarTo
/r/Synonym	is a synonym of
/r/UsedFor	is used for the purpose of
/r/dbpedia/product	product
